0 0 0 0 0 0 0 0 0
0 0 1 0 1 1 0 0 0
0 1 1 1 0 4 4 0 0
0 0 1 1 4 4 4 4 0
0 0 1 1 1 4 4 4 0
0 1 2 2 2 1 4 0 0
0 2 2 2 2 2 1 0 0
2 2 2 2 3 2 2 2 0
2 2 2 2 3 3 2 2 0
2 2 3 5 3 3 2 2 4
2 3 5 3 2 2 2 2 4
2 3 3 2 2 2 2 2 0
2 3 2 2 2 1 1 1 0
2 2 2 2 1 1 1 0 0
1 1 2 1 1 0 0 0 0
0 0 0 1 1 0 0 0 0
0 1 0 0 0 0 0 0 0
0 0 0 0 0 1 4 0 0
0 0 0 0 0 0 0 0 0